#################################
#-------------------------------#
#-C-----------------------------#
#-M-----------M-----------------#
#-------------########----------#
#-------------#--X-#------------#
#-------------#-----C#----------#
#-------------########----------#
#S----------------#C------------#
#################################
