###############################
#-----------------------------#
#-C---------------------------#
#-----------------------------#
#-------------########--------#
#-------------#--X-#M---------#
#-------------#---------------#
#-------------########--------#
#S---------------C#C----------#
###############################
